R 500 500
NO ./textures/NO.xpm
SO ./textures/SO.xpm
WE ./textures/WE.xpm
EA ./textures/EA.xpm
S ./items/treasure.xpm
S1 ./textures/barrel.xpm
D ./textures/door.xpm
B ./textures/bonus.xpm
A ./items/ammo.xpm
O ./ennemy/ennemy-1.xpm
T ./items/treasure.xpm
F 182,182,182
C 182,182,182

1 1 1 1 1 1 1 1 1 1 1 1 1 1 1 1 1 1 1 1 1 1 1 1 1 1 1 1 1
1 A 1 B 1 0 1 0 1 T 1 T 1 T 1 T 1 0 1 0 1 0 1 0 1 B 1 A 1
1 0 0 0 1 0 0 0 1 0 0 0 1 0 0 0 1 0 0 0 1 0 0 0 1 0 0 0 1
1 O 1 O 1 0 1 0 D 0 1 0 1 0 1 0 D 0 1 0 1 0 1 0 1 O 1 O 1
1 0 0 0 0 0 0 0 1 0 0 0 0 0 0 0 1 0 0 0 0 0 0 0 0 0 0 0 1
1 0 1 0 1 0 1 0 P 0 0 O O O 0 0 P 0 1 0 1 0 1 0 1 0 1 0 1
1 0 1 0 1 0 1 0 1 0 0 0 3 0 0 0 1 0 1 0 1 0 1 0 1 0 1 0 1
1 0 1 0 1 0 1 0 1 0 0 0 0 0 0 0 1 0 1 0 1 0 1 0 1 0 1 0 1
1 0 0 0 0 0 0 0 0 0 0 0 0 0 0 0 0 0 0 0 0 0 0 0 0 0 0 0 1
1 0 0 0 0 0 0 0 1 0 0 0 N 0 0 0 1 0 0 0 0 0 0 0 0 0 0 0 1
1 0 0 0 0 0 0 0 0 0 0 0 0 0 0 0 0 0 0 0 0 0 0 0 0 0 0 0 1
1 0 1 0 1 0 1 0 1 0 0 0 0 0 0 0 1 0 1 0 1 0 1 0 1 0 1 0 1
1 0 1 0 1 0 1 0 1 0 0 0 3 0 0 0 1 0 1 0 1 0 1 0 1 0 1 0 1
1 0 1 0 1 0 1 0 P 0 0 O O O 0 0 P 0 1 0 1 0 1 0 1 0 1 0 1
1 0 0 0 0 0 0 0 1 0 0 0 0 0 0 0 1 0 0 0 0 0 0 0 0 0 0 0 1
1 O 1 O 1 0 1 0 1 0 1 0 1 0 1 0 1 0 1 0 1 0 1 0 1 O 1 O 1
1 0 0 0 1 0 0 0 D 0 0 0 1 0 0 0 D 0 0 0 1 0 0 0 1 0 0 0 1
1 A 1 B 1 0 1 0 1 T 1 T 1 T 1 T 1 0 1 0 1 0 1 0 1 B 1 A 1
1 1 1 1 1 1 1 1 1 1 1 1 1 1 1 1 1 1 1 1 1 1 1 1 1 1 1 1 1
